{
"á":"a",
"ö":"oe",
"ü":"ue",
"í":"i",
"ñ":"n",
"é":"e",
"ä":"ae",
"ß":"ss",
"â":"a",
"å":"a",
"ø":"o",
"ï":"i",
"ç":"c",
"ã":"a",
"ê":"e",
"ý":"y",
"î":"i",
"ú":"u",
"ó":"o",
"à":"a",
"è":"e",
"ô":"o",
"ë":"e",
"ì":"i",
"ò":"o",
"õ":"o"
}
